R 1920 1080

NO ./text/redbrick.xpm

SO ./text/greystone.xpm

WE ./text/bluestone.xpm

EA ./text/eagle.xpm

S ./text/greenlight.xpm

F 220,100,0

C 225,30,0

1 1 1 1 1 1 1 1 1 1 1 1 1
1 1 1 1 1 0 0 0 0 0 0 0 1
1 0 0 0 1 0 1 2 0 0 0 1 1
1 1 1 0 0 0 0 1 1 1 0 1 1
1 1 1 0 2 0 0 0 0 1 0 0 1
1 1 0 0 0 0 0 0 0 1 0 0 1
1 1 1 1 1 0 0 0 0 0 0 0 1
1 1 1 1 1 0 0 0 0 0 0 0 1
1 0 0 0 0 0 0 1 1 0 0 0 1
1 0 0 0 0 0 1 0 0 1 0 0 1
1 1 1 1 1 1 2 0 0 0 0 0 1
1 0 0 0 0 0 W 1 1 0 1 1 1
1 1 1 1 1 1 1 1 1 1 1 1 1
