R 1280 720
NO ./path_north

SO ./path_sou

WE ./path_we

EA ./path_ea

S ./path_spr

F 220,100,0

C 225,30,0

1 1 1 1 1 1 1 1 1 1 1 1 1
1 1 1 1 1 0 0 0 0 0 0 0 1
1 0 0 0 1 0 1 0 0 0 0 1 1
1 1 1 0 0 0 0 1 1 1 0 1 1
1 1 1 0 0 0 0 0 0 1 0 0 1
1 1 0 0 0 0 0 0 0 1 0 0 1
1 1 1 1 1 0 0 0 0 0 0 0 1
1 1 1 1 1 0 0 0 0 0 0 0 1
1 0 0 0 0 0 0 1 1 0 0 0 1
1 0 0 0 0 0 1 0 0 1 0 0 1
1 1 1 1 1 1 0 0 0 0 0 0 1
1 0 0 0 0 0 N 1 1 0 1 1 1
1 1 1 1 1 1 1 1 1 1 1 1 1
